Shared Administrative Tools=shell:Common Administrative Tools
Administrative Tools=shell:Administrative Tools
SystemX86=shell:SystemX86
My Pictures=shell:My Pictures
Profile=shell:Profile
Shared Program Files=shell:CommonProgramFiles
Program Files=shell:ProgramFiles
System=shell:System
Windows=shell:Windows
History=shell:History
Cookies=shell:Cookies
Local Application Data=shell:Local AppData
Application Data=shell:AppData
Shared Documents=shell:Common Documents
Shared Templates=shell:Common Templates
Shared Application Data=shell:Common AppData
Shared Favorites=shell:Common Favorites
Shared Desktop=shell:Common Desktop
Shared Menu=shell:Common Menu
Shared Programs=shell:Common Programs
Shared Startup=shell:Common Startup
Templates=shell:Templates
PrintHood=shell:PrintHood
NetHood=shell:NetHood
Favorites=shell:Favorites
My Documents=shell:Personal
SendTo=shell:SendTo
Recent=shell:Recent
Programs=shell:Programs
Startup=shell:Startup
Desktop=shell:Desktop
Fonts=shell:Fonts
Connections Folder=shell:ConnectionsFolder
Recycle Bin Folder=shell:RecycleBinFolder
Printers Folder=shell:PrintersFolder
Control Panel Folder=shell:ControlPanelFolder
Internet Folder=shell:InternetFolder
My Computer=shell:DriveFolder
Network Folder=shell:NetworkFolder
Desktop Folder=shell:DesktopFolder
